##################
#   #        #   #
# #   ##  ##   # #
# ##          ## #
#  #   #  #   #  #
## ## #GGGG# ## ##
P     ######      
## ##        ## ##
## #####  ##### ##
#   ##      ##   #
# #    ####    # #
#   ##      ##   #
##################