#############
#    #      #
# #  # #### #
# #  # #  # #
# P       # #
  ### ###    
#     # # # #
# ### # # # #
#         # #
# ##### ### #
#           #
#############
